ADD	AE D
BROWSER	B R AW Z ER
CLOSE	K L OW S
CLOSE(2)	K L OW Z
DECREASE	D IH K R IY S
DECREASE(2)	D IY K R IY S
DISABLE	D IH S EY B AH L
GMAIL	G M EY L
INCREASE	IH N K R IY S
LOUDER	L AW D ER
NOTEPAD	N OW T P AE D
OPEN	OW P AH N
PROGRAM	P R OW G R AE M
QUIETER	K W AY AH T ER
REBOOT	R IY B UW T
SHOW	SH OW
SHUTDOWN	SH AH T D AW N
SLEEP	S L IY P
SOUND	S AW N D
TAKE	T EY K
TIME	T AY M
VOLUME	V AA L Y UW M
